21
1 1
111111111111111111111
400013000000001000001
101010111111101011101
121000100000001000101
111111101111111010121
101000001210001010101
101011111010101010111
101010000010100010001
101010111010111111101
101310001010131003001
131011101110101011101
101000100000001000101
101110101111111010111
100010100010001210001
111010111110101111101
100010001000100010001
101111101011111010101
100000100010001000101
101011111110101111101
121000000000100000004
111111111111111111111